***************************************************************
*............*...................................*....*.......*
*.....*......*........................................*.......*
*....****........................*..........*.................*
*......*..................*......*....*....*.*................*
*............*............****************************........*
******.....***..........................*.............*.......*
*.......................................*..............*......*
*.......................................*...............*.....*
*..................................******...........*****.....*
******.....***************.........................*..........*
*......................***........................*...........*
*.......................**....................................*
*........................*....................................*
*.....*******.....**.....*........******************..........*
*....***...***.....*...............................*..........*
*..................*...............................************
*..................*..........***********.....................*
*........*.........*..........**.......**.....................*
*....**..*..**.....*..........**..............................*
*.....*******.....**.....*....**..............................*
*........................*...........****......****...........*
*.......................**...........*............*...........*
*......................***...........*............*...........*
******.....***************.................**.................*
*...................******.....P...........**.................*
*...................**........................................*
*.....*****.........**...............*............*****.......*
*...................**...............*............*...........*
*...................**...............****......****...........*
*.........******....************..................*...........*
*...............*...************..................*...........*
*.....*..........*................................*...........*
*.....*...........*...............................*...*.......*
*................*....................................*.......*
*.....................................................*.......*
************************..............*........*......*.......*
*.....................................*........*..............*
*.....................................*........*..............*
*.....................................*........*.....***......*
*........*............................*........*..............*
*....*....*............****************........*..............*
******....*....................................*......*.......*
*....*....*...........................*........*..............*
*........*...........*****.....*****************..............*
*.............................................................*
*.............................................................*
***************************************************************